18,10,1,3
XXXXDDXXXX
XFFFFFFFFX
XFFFFFFFFX
XFFFFFFFFX
XFFFFFFFFX
XFFFFFFFFX
XFFFFFFFFX
XFFFFFFFFX
XFFFFFFFFX
XXXXFFXXXX
XXXXFFXXXX
XXXXFFXXXX
XXXXFFXXXX
XXXXFFXXXX
XXXXFFXXXX
XXXXFFXXXX
XXXXFFXXXX
XXXXXXXXXX