# file header
18,10,1,3  # 18 rows, 10 columns, player in position 1,3
XXXXDDXXXX # DD are doors
XFFFFFFFFX
XFFFFFFFFX
XFFFFFFFFX
XFFFFFFFFX
XFFFFFFFFX
XFFFFFFFFX
XFFFFFFFFX
XFFFFFFFFX
XXXXFFXXXX
XXXXFFXXXX
XXXXFFXXXX
XXXXFFXXXX
XXXXFFXXXX
XXXXFFXXXX
XXXXFFXXXX
XXXXFFXXXX
XXXXXXXXXX
0,10,5,0,0,0,0 # barrel at 10,5,0 position, with rotation 0,0,0